1111111111111
1001000P000C1
1000010111001 
10000E0000001
1C0011C000001
1C0011000C001
1C00110000001
1C00110001001
1C00110000001
1111111111111